111111111111111111111111111111
1P1E00000010000C00000000000001
10000100000000C1C000000001C001
1000000000000C111C000000000001
1000100C100000C1C0000000000111
100000000000000C000000000000C1
111111111111111111111111111111