11111111111111111111111111111111111111
110000100001C10000000000001C00000T0001
1P10000T000101000T000000001110000C0001
10110000000000000001CC1000000000C1C001
101E100T0100T000000111100T0000000C0001
10000000000000010TT0000000111000000001
100T00100000T000000000T0000C10000T0001
11111111111111111111111111111111111111