11111111111111111111111111111111111111111
110000100001C10000000000001C0000000000001
1P1000000001010000000000001110000C0000001
10110000000000000001CC1000000000C1C000001
101110000100000000011110000000000C0000001
10000000000000010000000000111000000000001
100000100000000000000000000C1000000000001
11111111111111111111111111111111111111111