11111111111111111111111111111111111111
110000100001C10000000000001C0000000001
1P100T00000101000000000000111T000C0001
10110000000000000001C10T00000000C1C001
101E10000100000000011110000000000C0001
1000000000T000010000000000111000000001
100000100000000000000000000C1000000001
11111111111111111111111111111111111111