11111111111111111111111111111111111111
110000100001C10000000000001C0000000001
1P10T000000101000T000000001110T00C0001
10110000T00000000001C1E0000T0000C1C001
101E10000100000000011110000000000C0001
1000000T000000T1000000000T111000000001
100000100000000000000000000C1000000001
11111111111111111111111111111111111111