111111111111111
1P1EC0000000001
100000000C00001
10000000C1C0001
1T0000000C00001
111111111111111