111111111111111
1P1EC1111111111
1C11CCCCCCCCC11
1C1111111111C11
1CCCCCCCCCCCC11
111111111111111