11111111111111111111111111111111111111
110000100001C10000000000001C0000000001
1P1000000001010000000000001110000C0001
10110000000000000001CC1000000000C1C001
101E10000100000000011110000000000C0001
10000000000000010000000000111000000001
100000100000000000000000000C1000000001
11111111111111111111111111111111111111