111111111111111
1P1EC1111111111
1011CCCC0CC0C11
101111111111C11
1CC0CC0C0C0CC11
111111111111111