11111111111111111111111111111111111111111
11000010000101000000000000100000000000001
1P100000000101000000000000111000000000001
10110000000000000001001000000000010000001
101110000100E0000001111000000000000000001
10000000000000010000000000111000000000001
10000010000000000000000000001000000000001
11111111111111111111111111111111111111111